{"map":[["⬜","⬜","⬜","⬜","🟨","⬜","⬜","⬜","⬜","⬜"],
				["⬜","⬜","⬜","⬜","⬜","🟥","⬜","⬜","⬜","⬜"],
				["⬜","⬜","🟩","⬜","🟨","⬜","⬜","⬜","⬜","⬜"],
				["⬜","⬜","⬜","⬜","⬜","⬜","⬜","⬜","⬜","⬜"],
				["⬜","⬜","⬜","⬜","🟨","⬜","🟥","⬜","⬜","⬜"],
				["⬜","⬜","⬜","⬜","⬜","⬜","⬜","⬜","⬜","⬜"],
				["⬜","⬜","⬜","⬜","🟨","⬜","⬜","⬜","⬜","⬜"],
				["⬜","⬜","⬜","⬜","⬜","⬜","⬜","⬜","⬜","⬜"],
				["⬜","⬜","⬜","⬜","🟨","⬜","⬜","⬜","⬜","⬜"],
				["⬜","⬜","⬜","⬜","⬜","⬜","⬜","⬜","⬜","⬜"]]}
